0000000010101010
1010101010101010
0010001010101010
0000000000000000
1111101000000000
0000000000000000
0000000011110111
0000000010000111
0000000010110001
0000000000100151
0000000011101101
0000000011100001