0000000010101010
1010101010101010
0010001010101010
0000000000000000
1111101000000000
0000000011111111
0000000011111111
0000000010000111
0000000010110111
0000000000100121
0000000011101101
0000000011100001